{
  "res" : "OK",
  "tiles" : [ [1, 1, 1, 1, 1, 1, 1, 1, 1 ],
              [1, 1, 1, 1, 1, 1, 1, 1, 1 ],
              [1, 1, 1, 1, 1, 1, 1, 1, 1 ],
              [1, 1, 1, 0, 0, 0, 0, 0, 0 ],
              [1, 1, 1, 0, 0, 0, 0, 0, 0 ],
              [1, 1, 1, 0, 0, 1, 1, 1, 1 ],
              [1, 1, 1, 0, 0, 1, 1, 1, 1 ],
              [1, 1, 1, 0, 0, 1, 1, 1, 1 ],
              [1, 1, 1, 0, 0, 1, 1, 1, 1 ] ],

  "targetScore" : 100000,
  "moves" : 30,
  "typesCount" : 4,
  "fieldObjects" : [[0, 0, 0, 0, 0, 0, 11, 10, 11 ],
					[0, 0, 0, 0, 0, 0, 10, 11, 10 ],
					[0, 0, 0, 0, 0, 0, 11, 10, 11 ],
					[21, 0, 21, 0, 0, 0, 0, 0, 0 ],
					[0, 21, 0, 0, 0, 0, 0, 0, 0 ],
					[0, 0, 0, 0, 0, 10, 10, 10, 10 ],
					[0, 0, 0, 0, 0, 10, 10, 10, 10 ],
					[0, 21, 0, 0, 0, 10, 10, 10, 10 ],
					[21, 10, 21, 0, 0, 10, 10, 10, 10 ] ],
}
