{
  "res" : "OK",
  "tiles" : [ [0, 0, 0, 0, 0, 0, 0, 0, 0 ],
              [0, 0, 0, 0, 0, 0, 0, 0, 0 ],
              [0, 0, 1, 1, 1, 1, 1, 0, 0 ],
              [0, 0, 1, 1, 1, 1, 1, 0, 0 ],
              [0, 0, 1, 1, 1, 1, 1, 0, 0 ],
              [0, 0, 1, 1, 1, 1, 1, 0, 0 ],
              [0, 0, 1, 1, 1, 1, 1, 0, 0 ],
              [0, 0, 0, 0, 0, 0, 0, 0, 0 ],
              [0, 0, 0, 0, 0, 0, 0, 0, 0 ] ],
  "predefinedCookies" : true,
  "cookies" : [ [0, 0, 0, 0, 0, 0, 0, 0, 0 ],
              [0, 0, 0, 0, 0, 0, 0, 0, 0 ],
              [0, 0, 2, 1, 4, 2, 1, 0, 0 ],
              [0, 0, 3, 2, 3, 1, 3, 0, 0 ],
              [0, 0, 2, 1, 1, 2, 1, 0, 0 ],
              [0, 0, 2, 3, 2, 1, 3, 0, 0 ],
              [0, 0, 1, 2, 1, 3, 1, 0, 0 ],
              [0, 0, 0, 0, 0, 0, 0, 0, 0 ],
              [0, 0, 0, 0, 0, 0, 0, 0, 0 ] ],
  "targetScore" : 1000,
  "moves" : 15,
  "typesCount" : 5,
  "fieldObjects" : [ [0, 0, 0, 0, 0, 0, 0, 0, 0 ],
              [0, 0, 0, 0, 0, 0, 0, 0, 0 ],
              [0, 0, 0, 0, 0, 0, 0, 0, 0 ],
              [0, 0, 0, 0, 0, 0, 0, 0, 0 ],
              [0, 0, 0, 0, 0, 0, 0, 0, 0 ],
              [0, 0, 0, 0, 0, 0, 0, 0, 0 ],
              [0, 0, 0, 0, 0, 0, 0, 0, 0 ],
              [0, 0, 0, 0, 0, 0, 0, 0, 0 ],
              [0, 0, 0, 0, 0, 0, 0, 0, 0 ] ],
}
