{
  "res" : "OK",
  "tiles" : [ [1, 1, 1, 1, 1, 1, 1, 1, 1 ],
              [1, 1, 1, 1, 1, 1, 1, 1, 1 ],
              [1, 1, 1, 1, 1, 1, 1, 1, 1 ],
              [0, 1, 1, 0, 0, 0, 1, 1, 0 ],
              [0, 1, 1, 0, 0, 0, 1, 1, 0 ],
              [1, 1, 1, 1, 0, 1, 1, 1, 1 ],
              [1, 1, 1, 1, 0, 1, 1, 1, 1 ],
              [1, 1, 1, 1, 0, 1, 1, 1, 1 ],
              [1, 1, 1, 1, 0, 1, 1, 1, 1 ] ],

  "targetScore" : 20000,
  "moves" : 30,
  "typesCount" : 3,
  "fieldObjects" : [ [30, 0, 0, 0, 0, 0, 0, 0, 30 ],
              [30, 0, 0, 0, 0, 0, 0, 0, 30 ],
              [30, 30, 30, 30, 30, 30, 30, 30, 30 ],
              [0, 21, 21, 0, 0, 0, 21, 21, 0 ],
              [0, 21, 21, 0, 0, 0, 21, 21, 0 ],
              [0, 0, 0, 0, 0, 0, 0, 0, 0 ],
              [0, 0, 0, 0, 0, 0, 0, 0, 0 ],
              [30, 0, 30, 0, 0, 0, 30, 0, 30 ],
              [0, 30, 0, 30, 0, 30, 0, 30, 0 ] ],
}
