{
  "res" : "OK",
  "tiles" : [ [0, 1, 1, 1, 1, 1, 1, 1, 0 ],
              [0, 1, 1, 1, 1, 1, 1, 1, 0 ],
              [0, 1, 1, 1, 1, 1, 1, 1, 0 ],
              [0, 1, 1, 1, 1, 1, 1, 1, 0 ],
              [0, 1, 1, 1, 1, 1, 1, 1, 0 ],
              [0, 1, 1, 1, 1, 1, 1, 1, 0 ],
              [0, 1, 1, 1, 1, 1, 1, 1, 0 ],
              [0, 1, 1, 1, 1, 1, 1, 1, 0 ],
              [0, 1, 1, 1, 1, 1, 1, 1, 0 ] ],

  "targetScore" : 60000,
  "moves" : 20,
  "typesCount" : 4,
  "fieldObjects" : [ [0, 0, 0, 0, 0, 0, 0, 0, 0 ],
					[0, 0, 0, 0, 0, 0, 0, 0, 0 ],
					[0, 0, 0, 0, 0, 0, 0, 0, 0 ],
					[0, 0, 0, 0, 0, 0, 0, 0, 0 ],
					[0, 21, 21, 21, 21, 21, 21, 21, 0 ],
					[0, 0, 0, 0, 21, 0, 0, 0, 0 ],
					[0, 0, 0, 0, 21, 0, 0, 0, 0 ],
					[0, 0, 0, 0, 21, 0, 0, 0, 0 ],
					[0, 0, 0, 0, 21, 0, 0, 0, 0 ] ],
}
