{
  "res" : "OK",
  "tiles" : [ [1, 1, 1, 1, 1, 1, 1, 1, 1 ],
              [1, 1, 1, 1, 1, 1, 1, 1, 1 ],
              [1, 1, 1, 1, 1, 1, 1, 1, 1 ],
              [1, 1, 1, 0, 0, 0, 0, 0, 0 ],
              [1, 1, 1, 0, 0, 0, 0, 0, 0 ],
              [1, 1, 1, 0, 0, 1, 1, 1, 1 ],
              [1, 1, 1, 0, 0, 1, 1, 1, 1 ],
              [1, 1, 1, 0, 0, 1, 1, 1, 1 ],
              [1, 1, 1, 0, 0, 1, 1, 1, 1 ] ],

  "targetScore" : 100000,
  "moves" : 30,
  "typesCount" : 4,
  "fieldObjects" : [[0, 0, 0, 0, 0, 0, 12, 11, 12 ],
					[0, 0, 0, 0, 0, 0, 11, 12, 11 ],
					[0, 0, 0, 0, 0, 0, 12, 11, 12 ],
					[22, 0, 22, 0, 0, 0, 0, 0, 0 ],
					[0, 22, 0, 0, 0, 0, 0, 0, 0 ],
					[0, 0, 0, 0, 0, 11, 11, 11, 11 ],
					[0, 0, 0, 0, 0, 11, 11, 11, 11 ],
					[0, 22, 0, 0, 0, 11, 11, 11, 11 ],
					[22, 11, 22, 0, 0, 11, 11, 11, 11 ] ],
}
