{
  "res" : "OK",
  "tiles" : [ [1, 1, 1, 1, 1, 1, 1, 1, 1 ],
              [1, 1, 1, 1, 1, 1, 1, 1, 1 ],
              [1, 1, 1, 1, 1, 1, 1, 1, 1 ],
              [0, 0, 0, 1, 1, 1, 0, 0, 0 ],
              [0, 0, 0, 1, 1, 1, 0, 0, 0 ],
              [0, 0, 0, 1, 1, 1, 0, 0, 0 ],
              [1, 1, 1, 1, 1, 1, 1, 1, 1 ],
              [1, 1, 1, 1, 1, 1, 1, 1, 1 ],
              [1, 1, 1, 1, 1, 1, 1, 1, 1 ] ],

  "targetScore" : 1000,
  "moves" : 15,
  "typesCount" : 3,
  "fieldObjects" : [ [0, 0, 0, 0, 0, 0, 0, 0, 0 ],
					[0, 0, 0, 0, 0, 0, 0, 0, 0 ],
					[0, 0, 0, 0, 0, 0, 0, 0, 0 ],
					[0, 0, 0, 11, 11, 11, 0, 0, 0 ],
					[0, 0, 0, 11, 11, 11, 0, 0, 0 ],
					[0, 0, 0, 11, 11, 11, 0, 0, 0 ],
					[0, 0, 0, 0, 0, 0, 0, 0, 0 ],
					[0, 0, 0, 0, 0, 0, 0, 0, 0 ],
					[0, 0, 0, 0, 0, 0, 0, 0, 0 ] ],
}
