{
    "res" : "OK",
    "tiles" : [ [1, 1, 0, 0, 1, 0, 0, 1, 1 ],
              [1, 0, 0, 1, 1, 1, 0, 0, 1 ],
              [0, 0, 1, 1, 1, 1, 1, 0, 0 ],
              [0, 1, 1, 1, 1, 1, 1, 1, 0 ],
              [1, 1, 1, 1, 1, 1, 1, 1, 1 ],
              [0, 1, 1, 1, 1, 1, 1, 1, 0 ],
              [0, 0, 1, 1, 1, 1, 1, 0, 0 ],
              [1, 0, 0, 1, 1, 1, 0, 0, 1 ],
              [1, 1, 0, 0, 1, 0, 0, 1, 1 ] ],

    "targetScore" : 15000,
    "moves" : 15,
    "typesCount" : 3,
    "skipEmptyHoles" : true,
    "fieldObjects" : [ [0, 0, 0, 0, 0, 0, 0, 0, 0 ],
              [0, 0, 0, 0, 0, 0, 0, 0, 0 ],
              [0, 0, 0, 0, 0, 0, 0, 0, 0 ],
              [0, 0, 0, 0, 21, 0, 0, 0, 0 ],
              [0, 0, 0, 21, 30, 21, 0, 0, 0 ],
              [0, 0, 0, 0, 21, 0, 0, 0, 0 ],
              [0, 0, 0, 0, 0, 0, 0, 0, 0 ],
              [0, 0, 0, 0, 0, 0, 0, 0, 0 ],
              [0, 0, 0, 0, 0, 0, 0, 0, 0 ] ],
    "levelGoals": 
    {
        "goalsCount" : 1,
        "collect" : [ { "baseObjType": 1, "objType": 2, "targetCount": 30 } ],
    }
}
