{
    "res" : "OK",
    "tiles" : [ [0, 1, 1, 0, 0, 0, 1, 1, 0 ],
              [1, 1, 1, 1, 1, 1, 1, 1, 1 ],
              [1, 1, 1, 1, 1, 1, 1, 1, 1 ],
              [1, 1, 1, 1, 1, 1, 1, 1, 1 ],
              [0, 0, 1, 1, 1, 1, 1, 0, 0 ],
              [1, 1, 1, 1, 1, 1, 1, 1, 1 ],
              [1, 1, 1, 1, 1, 1, 1, 1, 1 ],
              [1, 1, 1, 1, 1, 1, 1, 1, 1 ],
              [0, 1, 1, 0, 0, 0, 1, 1, 0 ] ],

    "fieldObjects" : [ [0, 20, 20, 0, 0, 0, 20, 20, 0 ],
              [0, 0, 0, 0, 0, 0, 0, 0, 0 ],
              [0, 0, 0, 0, 0, 0, 0, 0, 0 ],
              [0, 0, 0, 30, 30, 30, 0, 0, 0 ],
              [0, 0, 0, 30, 10, 30, 0, 0, 0 ],
              [0, 0, 0, 30, 30, 30, 0, 0, 0 ],
              [0, 0, 0, 0, 0, 0, 0, 0, 0 ],
              [0, 0, 0, 0, 0, 0, 0, 0, 0 ],
              [0, 20, 20, 0, 0, 0, 20, 20, 0 ] ],
              
    "targetScore" : 1000,
    "moves" : 15,
    "typesCount" : 5,
    "levelGoals": 
    {
        "goalsCount" : 2,
        "collect" : [ { "baseObjType": 1, "objType": 1, "count": 20 }, 
                     { "baseObjType": 2, "objType": 20, "count": 4 } ],
    }
}
